{
  "dimensions": [5, 5],
  "limits": {
    "code": 100,
    "compute": 1000
  },
  "rate": 1000,
  "start": [4, 0],
  "finish": [4, 4],
  "frames": [
    [[1, 1, 0, 0, 0], [0, 1, 0, 0, 1], [0, 0, 1, 1, 0], [0, 0, 1, 1, 0], [1, 1, 1, 1, 1]],
    [[0, 1, 1, 1, 1], [1, 0, 1, 1, 0], [1, 1, 0, 0, 0], [1, 0, 0, 0, 0], [0, 0, 0, 0, 0]],
    [[0, 1, 1, 0, 1], [1, 1, 1, 0, 1], [0, 1, 0, 0, 1], [1, 0, 0, 0, 1], [0, 0, 0, 0, 0]],
    [[0, 1, 1, 1, 1], [0, 0, 1, 0, 0], [1, 1, 0, 0, 1], [1, 0, 0, 1, 1], [0, 0, 0, 0, 0]],
    [[0, 1, 0, 0, 1], [0, 1, 0, 0, 1], [1, 0, 0, 1, 1], [1, 0, 0, 0, 1], [0, 0, 0, 0, 0]],
    [[0, 0, 0, 1, 1], [1, 1, 1, 1, 1], [1, 1, 0, 0, 0], [1, 0, 0, 0, 0], [0, 0, 0, 0, 0]],
    [[0, 0, 1, 1, 0], [0, 0, 1, 1, 1], [0, 1, 0, 1, 1], [1, 0, 0, 0, 0], [0, 0, 0, 0, 0]],
    [[0, 0, 1, 1, 0], [0, 1, 0, 0, 1], [1, 0, 0, 1, 1], [1, 0, 0, 1, 0], [0, 0, 0, 0, 0]],
    [[1, 1, 1, 0, 0], [0, 0, 0, 1, 1], [1, 1, 0, 0, 0], [1, 0, 0, 1, 0], [0, 0, 0, 0, 0]]
  ]
}
