{
  "dimensions": [5, 5],
  "limits": {
    "code": 100,
    "compute": 1000
  },
  "rate": 200,
  "start": [0, 5],
  "finish": [5, 0],
  "frames": [
    [[0, 0, 0, 0, 0],
     [1, 1, 1, 0, 0],
     [1, 1, 1, 0, 0],
     [0, 1, 1, 0, 0],
     [0, 1, 1, 0, 1]],
    [[0, 1, 0, 0, 0],
     [1, 1, 1, 0, 0],
     [0, 0, 1, 0, 0],
     [0, 1, 1, 1, 1],
     [1, 1, 1, 0, 0]],
    [[1, 1, 1, 0, 0],
     [1, 1, 1, 1, 0],
     [0, 0, 1, 0, 1],
     [1, 0, 0, 0, 0],
     [1, 1, 1, 0, 0]],
    [[1, 1, 1, 0, 0],
     [1, 0, 1, 0, 1],
     [1, 0, 1, 0, 0],
     [1, 0, 0, 1, 0],
     [0, 1, 1, 0, 0]],
    [[1, 1, 1, 1, 0],
     [1, 1, 1, 0, 1],
     [1, 0, 1, 0, 0],
     [1, 0, 0, 1, 0],
     [1, 0, 1, 0, 0]],
    [[1, 1, 1, 0, 0],
     [1, 1, 1, 1, 0],
     [1, 1, 0, 0, 0],
     [0, 1, 0, 0, 0],
     [0, 1, 1, 1, 0]],
    [[0, 1, 1, 1, 0],
     [0, 1, 1, 0, 0],
     [1, 1, 0, 0, 0],
     [1, 1, 0, 1, 0],
     [0, 1, 1, 1, 0]],
    [[0, 1, 0, 1, 0],
     [0, 1, 0, 1, 0],
     [0, 1, 1, 0, 0],
     [0, 1, 1, 1, 0],
     [1, 1, 0, 0, 0]],
    [[0, 1, 1, 1, 0],
     [0, 1, 1, 0, 0],
     [0, 1, 1, 0, 0],
     [0, 0, 1, 1, 0],
     [0, 0, 0, 0, 0]],
    [[0, 0, 1, 1, 0],
     [0, 0, 1, 1, 1],
     [0, 1, 1, 0, 0],
     [0, 1, 1, 0, 0],
     [0, 1, 0, 1, 0]],
    [[0, 0, 1, 0, 0],
     [0, 0, 1, 0, 0],
     [0, 0, 1, 1, 0],
     [0, 0, 1, 1, 1],
     [0, 0, 0, 1, 1]],
    [[0, 0, 1, 1, 0],
     [0, 0, 1, 0, 0],
     [0, 0, 1, 1, 1],
     [0, 0, 1, 1, 0],
     [0, 0, 0, 1, 0]],
    [[0, 1, 0, 1, 0],
     [0, 0, 1, 1, 1],
     [0, 0, 1, 1, 1],
     [0, 0, 1, 0, 0],
     [0, 0, 0, 0, 0]]
  ]
}
